######     ######
#    #     #    #
#    #######    #
#       $    @ .#
#    #######    #
# $  #     # .  #
#    #     #    #
######     ######
; 1
